11111111111111111111111111111111111111111111111111111111111
1000000P0C000000E0000000000000000000000000000000000000000001
11111111111111111111111111111111111111111111111111111111111