1111111111111
10010000000C1
1000011110111
1P011E0000011
1111111111111
1110000000111
1111111101111
