11111111111111111111111111111111111111111111111111
10000000000000000000000000110000000000000000000001
10000000000000000000000000110000000000000000000001
10000000000000000000000000110000000000000000000001
10000000000000000000000000110000000000000000000001
1000000000000000000CCC0000100000000000000000000011
1000000000000000000CPC0000110000000000000000000001
1000000000000000000CCC0000110000000000000000000001
10000000000000000000000000110000000000000000000001
10000000000000000000000000100000000000000000000011
1000000000000000000CCC0000110000000000000000000001
1000000000000000000CEC0000110000000000000000000001
1000000000000000000CCCC000110000000000000000000001
10000000000000000000000000110000000000000000000001
10000000000000000000000000110000000000000000000001
10000000000000000000000000110000000000000000000001
10000000000000000000000000110000000000000000000001
10000000000000000000000000110000000000000000000001
10000000000000000000000000110000000000000000000001
10000000000000000000000000110000000000000000000001
10000000000000000000000000110000000000000000000001
10000000000000000000000000110000000000000000000001
10000000000000000000000000110000000000000000000001
11111111111111111111111111111111111111111111111111
11111111111111111111111111111111111111111111111111