1111111111111
10010000000C1
1000011110111
1P011E0000011
1111111111111
111000C000111
1111111111111