1111111
100C001
10P0001
100E001
1111011
