11111111111
1000P000011
11C00C00101
1C1E0000001
11111111111